+-/+-*=--+/-+-=+
|             *|
+  +-!+=-+ -+  +
=  |     |     /
+  +--=  +--+  +
/     |     |  =
+-=+  +/-+  +  +
|     |        *
+  +--+  +  +!*+
|        =     g
=-*+!-+/-+-/+**+
